{
	"Level1": [
		[ 0, 0, 0, 0, 0, 0, 0, 0],
		[ 0, 0, 0, 0, 0, 0, 0, 0],
		[ 0, 0, 0, 0, 0, 0, 0, 0],
		[ 0, 0, 0, 6, 5, 0, 0, 0],
		[ 0, 0, 0, 0, 0, 0, 0, 4],
		[ 0, 0, 0, 0, 0, 0, 4, 8],
		[ 7, 0, 3, 0, 4, 1, 8, 2],
		[ 9, 1, 1, 1, 8, 2, 2, 2]
	]
}
